NO ./exec/img2.xpm

    WE ./exec/img4.xpm

    SO ./exec/img1.xpm
EA ./exec/img3.xpm





 C 250,200,210



F 188,143,143





   111111111
   10000000111
   10010E010011
 11110000000001
 1000000000111111111111111111111111111111111111111111111111111111111111111111111111111111111111111111111111
 1000001000000001000000000001000000000000000001000000000001000000000000000010000000000010000000000100000001
 1000000000000000100000000000100000000000100000000000100000000000000001000000000001000000000000000010000001
 100000100000000000100000000000100000000000100000000000100000000000000001000000000001000000000000000010000001
 100000000000000010000000000010000000000000100000000000100000000000000001000000000001000000000000001000000001
 100000100000000100000000000100000000000000001000000000001000000000000000010000000000010000000000010000000001
 111111111111111111111111111111111111111111111111111111111111111111111111111111111111111111111111111111111111